NO ./textures/leaves.xpm
SO ./textures/snow.xpm
WE   ./textures/microbes.xpm

EA ./textures/frost.xpm


F 255,255,255
C 30,30,50

  1111
 110N11
 111111