NO ./textures/leaves.xpm
SO ./textures/snow.xpm
WE   ./textures/microbes.xpm

EA ./textures/frost.xpm


F 255,255,255
C 30,30,50

   111  11111  11   111    11111
     1   1111 111   111  1111 11
        1111111111111111111111111
        1000000000110000000000001
        1011000001110001010000101
        1001000000000000000000011
111111111011000001110000000000001
100000000011000001110111111111111
11110111111111011100000000001
11110111111111011101010000001
11000000110101011100000010001
10000000000000001100000010001
10000000000000001101010010001
11000001110101011111011110E0111
11110111 1110101 101111010001
11111111 1111111 111111111111