NO ./path_to_the_north_texture
SO ./path_to_the_south_texture
WE   ./path_to_the_west_texture

EA ./path_to_the_east_texture


F 220,100,0
C 225,30,0

   111  11111  11   111    11111
     1   1111 111   111  1111 11
        1111111111111111111111111
        1000000000110000000000001
        1011000001110000000000001
        1001000000000000000000001
111111111011000001110000000000001
100000000011000001110111111111111
111101111111110111000000000011111
111101111111110111010100000011111
110000001101010111000000100011111
100000000000000011000000100011111
100000000000000011010100100011111
11000001110101011111011110N011111
111101111111010111011110100011111
111111111111111111111111111111111