NO   ./textures/leaves.xpm
SO ./textures/snow.xpm
WE                   ./textures/microbes.xpm

EA ./textures/frost.xpm


C 0,30,60


F          220,230,230


        1111111111111111111111111
        1000000000110000000000001
        1011000001110000001000001
        1001000000000000000000001
111111111011000001110000000000001
100000000011000001110111111111111
111101111111110111000000000011111
111101111111110111010100000011111
110000001101010111000000100011111
100000000000000000000000100011111
100000000000000011010100000011111
11000001110101011111011110N011111
111101111111010111011110100011111
111111111111111111111111111111111