NO ./textures/leaves.xpm
SO ./textures/snow.xpm
WE   ./textures/microbes.xpm

EA ./textures/frost.xpm


F 255,255,255
C 30,30,50

11111111111
10010000001
100D0000001
1D110000001
100W0001001
1000000D001
10000001001
10000000001
11111111111