NO ./textures/leaves.xpm
SO ./textures/snow.xpm
EA ./textures/frost.xpm
WE ./textures/microbes.xpm

F 215,215,215
C 30,30,55

111111111111111111111
101000001000000000001
101D10101011111110001
100010100010000010001
111110101111101D11101
1000001D1000101000001
101111101011101111111
101000001010100000101
101011111010111110101
1D1010001010100010101
10111D1010101D1010101
100000101010001D10001
111111101011111011101
100000101000100010001
101110101110101110111
1D1000100000100010101
101011111111111D10101
100010000000000010001
101D10111011111111101
1N1000001000000000001
111111111111111111111