NO   ./textures/leaves.xpm
SO ./textures/snow.xpm
WE                   ./textures/microbes.xpm

EA ./textures/frost.xpm


F 225,225,225


C          0,0,1

   111  11111  11   111    11111
     1   1111 111   111  1111 11
        1111111111111111111111111
        1000000000110000000000001
        1011000001110000001000001
        1001000000D00000000000001
111111111D11000001110000000000001
10000000001100000111D111111111111
1111D1111111110111000000000011111
11110111111111D111010100000011111
110000001101010111000000100011111
1000000000000000D0000000100011111
100000000000000011010100D00011111
110000011101010111110111100011111
111101111111010111011110100011111
111111111111111111111111111111111